{
  "mapWidth": 10,
  "mapHeight": 10,
  "tileSize": 48,
  "room0": [
    {
      "name": "Background",
      "type": "tileLayer",
      "data":
      [
        0, 0, 0, 0, 0, 0, 0, 0, 0, 0,
        0, 3, 3, 3, 3, 3, 3, 3, 3, 0,
        0, 3, 3, 3, 3, 3, 3, 3, 3, 0,
        0, 3, 3, 3, 3, 3, 3, 3, 3, 0,
        0, 3, 3, 3, 3, 3, 3, 3, 3, 3,
        0, 3, 3, 3, 3, 3, 3, 3, 3, 3,
        0, 3, 3, 3, 3, 3, 3, 3, 3, 3,
        0, 3, 3, 3, 3, 3, 3, 3, 3, 0,
        0, 3, 3, 3, 3, 3, 3, 2, 3, 0,
        0, 0, 0, 0, 0, 0, 0, 0, 0, 0
      ]
    },
    {
      "name": "Entities",
      "type": "objectGroup",
      "spawnData": [
        2, 2, 2, 2, 2, 2, 2, 2, 2, 2,
        2, 0, 0, 2, 0, 0, 0, 0, 0, 2,
        2, 0, 0, 2, 0, 0, 0, 0, 0, 2,
        2, 0, 0, 2, 0, 0, 0, 0, 0, 2,
        2, 0, 0, 0, 0, 0, 0, 0, 0, 0,
        2, 0, 0, 0, 1, 0, 0, 0, 0, 0,
        2, 0, 0, 0, 0, 0, 2, 0, 0, 0,
        2, 0, 0, 0, 0, 0, 2, 0, 0, 2,
        2, 0, 0, 0, 0, 0, 2, 0, 0, 2,
        2, 2, 2, 2, 2, 2, 2, 2, 2, 2
      ]
    }
  ]
}