{
  "mapWidth": 10,
  "mapHeight": 10,
  "tileSize": 48,
  "room0": [
    {
      "name": "Background",
      "type": "tileLayer",
      "data":
      [
        0, 0, 0, 0, 0, 0, 0, 0, 0, 0,
        0, 3, 3, 0, 3, 3, 3, 0, 3, 0,
        0, 3, 3, 0, 3, 0, 3, 0, 3, 0,
        0, 3, 3, 0, 3, 0, 3, 0, 3, 0,
        0, 3, 3, 0, 3, 0, 3, 0, 3, 3,
        0, 3, 3, 0, 3, 0, 3, 0, 3, 3,
        0, 3, 3, 0, 3, 0, 3, 0, 3, 3,
        0, 3, 3, 0, 3, 0, 3, 0, 3, 0,
        0, 3, 3, 3, 3, 0, 3, 3, 3, 0,
        0, 0, 0, 0, 0, 0, 0, 0, 0, 0
      ]
    },
    {
      "name": "Entities",
      "type": "objectGroup",
      "spawnData": [
        2, 2, 2, 2, 2, 2, 2, 2, 2, 2,
        2, 0, 0, 2, 0, 0, 0, 2, 0, 2,
        2, 0, 0, 2, 0, 2, 0, 2, 0, 2,
        2, 0, 0, 2, 0, 2, 0, 2, 0, 2,
        2, 0, 0, 2, 1, 2, 0, 2, 0, 0,
        2, 0, 0, 2, 0, 2, 0, 2, 0, 0,
        2, 0, 0, 2, 0, 2, 0, 2, 0, 0,
        2, 0, 0, 2, 0, 2, 0, 2, 0, 2,
        2, 0, 0, 0, 0, 2, 0, 0, 0, 2,
        2, 2, 2, 2, 2, 2, 2, 2, 2, 2
      ]
    }
  ]
}