{
  "roomWidth": 10,
  "roomHeight": 10,
  "tileSize": 48,
  "room": [
    {
      "name": "Background",
      "type": "tileLayer",
      "data":
      [
        0, 0, 0, 0, 0, 0, 0, 0, 0, 0,
        0, 1, 1, 1, 1, 1, 1, 1, 1, 0,
        0, 1, 0, 0, 1, 0, 0, 0, 1, 0,
        0, 1, 0, 0, 1, 0, 0, 0, 1, 0,
        0, 1, 0, 3, 3, 3, 0, 0, 1, 3,
        0, 1, 0, 3, 3, 3, 0, 0, 1, 3,
        0, 1, 0, 3, 3, 3, 0, 0, 1, 3,
        0, 1, 0, 0, 1, 0, 0, 0, 1, 0,
        0, 1, 1, 1, 1, 1, 1, 1, 1, 0,
        0, 0, 0, 0, 0, 0, 0, 0, 0, 0
      ]
    },
    {
      "name": "Entities",
      "type": "objectGroup",
      "spawnData": [
        2, 2, 2, 2, 2, 2, 2, 2, 2, 2,
        2, 0, 0, 0, 0, 0, 0, 0, 0, 2,
        2, 0, 2, 2, 0, 2, 2, 2, 0, 2,
        2, 0, 2, 2, 0, 2, 2, 2, 0, 2,
        2, 0, 2, 0, 0, 0, 2, 2, 0, 0,
        2, 0, 2, 0, 1, 0, 2, 2, 0, 0,
        2, 0, 2, 0, 0, 0, 2, 2, 0, 0,
        2, 0, 2, 2, 0, 2, 2, 2, 0, 2,
        2, 0, 0, 0, 0, 0, 0, 0, 0, 2,
        2, 2, 2, 2, 2, 2, 2, 2, 2, 2
      ]
    }
  ]
}